6,16,13,6,10,9,20,3,3,0
16,16,6,0,6,10,6,3,10,6
13,6,3,3,0,3,3,0,6,10
3,3,13,23,6,3,10,3,3,3
3,0,3,9,13,3,6,3,13,3
13,3,6,16,19,9,10,6,13,3
16,6,23,19,19,13,6,3,3,0
23,6,3,3,3,3,6,10,3,3
6,10,3,0,0,3,10,6,3,20
0,3,0,0,0,0,3,0,0,3
