13,19,16,13,6,13,6,6,10,3
6,13,9,3,3,19,16,23,6,0
0,9,10,3,3,13,6,3,0,0
6,10,9,3,3,3,0,0,0,0
10,9,13,16,16,6,0,0,3,0
6,0,3,6,26,13,6,3,10,3
13,3,0,0,3,6,10,3,6,3
26,3,3,0,0,0,6,3,13,13
13,6,10,3,0,3,10,3,3,3
3,0,3,0,0,0,3,0,0,0
