0,3,3,3,13,16,9,10,3,0
6,13,13,3,6,19,16,6,3,0
10,9,6,0,6,26,16,6,13,6
6,23,13,6,10,9,3,6,16,16
0,6,3,0,6,10,6,10,12,13
3,10,3,0,3,3,0,6,13,6
0,3,0,6,30,3,0,6,13,6
0,0,6,13,6,0,3,13,9,10
0,3,13,16,3,0,3,13,3,3
0,0,3,3,0,0,0,3,0,0
