0,0,0,3,0,0,0,0,0,0
3,0,3,10,3,3,0,0,0,3
13,3,0,3,3,10,3,3,3,13
16,3,0,0,3,3,6,10,6,13
13,3,0,3,10,9,10,6,0,3
6,3,0,0,6,10,9,0,3,0
13,23,6,3,3,6,13,9,10,3
3,6,13,16,16,9,16,13,6,0
0,0,3,6,16,13,6,3,0,0
0,0,0,0,3,3,0,0,0,0
