3,0,0,0,0,3,10,6,10,3
10,3,0,0,3,3,6,3,6,0
3,0,3,3,13,19,16,16,13,3
0,6,10,3,9,13,9,6,6,3
3,13,6,3,13,12,13,16,16,23
6,13,3,3,26,13,9,3,3,3
20,6,0,0,3,9,10,3,0,0
3,0,0,3,3,10,9,0,3,0
0,0,3,10,3,6,10,6,10,3
0,0,0,3,0,0,3,0,3,0
