13,16,16,3,3,3,13,6,10,3
3,6,13,6,10,9,13,3,3,0
0,3,3,0,6,10,6,3,0,0
3,13,3,0,0,3,3,23,3,3
3,13,3,0,3,3,3,23,6,10
0,3,0,3,16,26,6,3,3,6
3,3,3,6,19,19,13,6,13,13
13,26,16,16,16,9,3,0,6,3
3,3,3,3,6,10,3,3,20,3
0,0,0,0,0,3,0,0,3,0
