10,9,13,26,16,16,13,3,3,3
9,10,6,6,3,6,3,3,23,13
10,6,3,10,9,10,6,3,3,3
6,0,0,6,10,9,13,23,3,3
13,3,0,0,3,0,3,6,3,10
13,6,0,0,0,0,3,23,3,6
9,10,6,0,0,0,3,13,6,10
13,9,10,6,0,3,0,3,0,3
23,3,6,10,6,10,3,0,0,0
3,0,0,3,0,3,0,0,0,0
