3,3,0,3,13,23,9,23,3,0
13,13,3,0,6,6,13,16,6,0
3,3,0,3,20,3,3,6,10,3
3,0,0,3,6,0,0,3,3,3
13,6,3,13,13,6,3,10,6,10
16,13,3,3,9,10,3,3,3,3
3,6,0,3,10,9,3,6,10,6
3,10,3,0,6,16,29,16,9,10
0,3,0,0,3,16,19,16,3,3
0,0,0,0,0,3,3,3,0,0
