10,3,3,16,16,3,3,3,3,3
3,0,6,16,19,6,13,16,16,13
3,3,10,12,13,6,6,3,3,3
13,3,6,10,12,13,13,3,0,0
13,3,0,6,10,6,3,0,0,0
3,0,0,0,3,0,0,0,0,3
3,3,0,3,3,0,0,0,3,13
13,13,6,13,16,3,0,3,3,13
3,3,0,6,13,3,3,10,3,3
0,0,0,0,3,0,0,3,0,0
