13,16,6,10,3,3,20,3,0,0
6,13,3,6,0,0,3,0,0,0
0,6,3,13,6,0,3,0,0,3
3,20,6,19,16,9,10,3,6,10
0,3,3,19,22,13,9,3,10,6
0,0,3,16,16,9,10,3,6,0
3,0,3,3,3,3,6,3,10,6
13,6,10,6,3,16,13,3,9,13
13,3,6,10,6,13,6,3,13,26
3,0,0,3,0,3,0,0,3,3
