0,0,3,0,0,0,0,0,3,3
0,6,10,3,3,0,3,3,13,13
3,13,6,3,13,9,13,3,3,3
3,13,3,3,26,16,16,6,0,0
0,3,0,0,3,3,6,20,3,3
3,0,0,0,0,0,0,3,3,13
10,3,0,0,0,0,0,3,3,23
3,0,0,0,0,3,3,10,6,3
0,0,0,0,3,10,3,6,10,3
0,0,0,0,0,3,0,0,3,0
