6,10,3,0,3,13,6,16,13,3
10,6,0,0,6,16,6,23,6,3
3,0,0,3,13,26,6,3,3,10
3,0,0,0,3,9,10,3,3,6
10,3,0,0,6,13,6,3,13,13
3,3,0,6,16,16,6,0,3,6
3,13,6,13,16,9,10,3,3,13
3,13,3,6,3,3,3,0,3,13
0,3,3,10,6,10,3,0,0,3
0,0,0,3,0,3,0,0,0,0
