13,16,3,0,3,30,3,0,3,0
6,16,3,3,0,3,0,6,23,3
6,13,6,10,6,0,6,13,26,3
20,6,0,6,23,9,20,6,3,0
3,0,0,3,16,16,6,0,0,3
3,0,3,0,6,13,6,3,3,20
10,6,10,3,0,6,16,13,3,6
3,0,6,0,3,6,16,9,6,10
0,3,20,6,13,16,19,16,13,6
0,0,3,0,3,3,3,3,3,0
