6,13,13,3,6,10,9,26,16,3
10,9,3,6,13,12,13,19,19,3
6,13,6,16,19,16,6,6,23,3
3,13,9,13,9,13,3,0,3,3
0,9,10,6,0,6,0,3,3,10
3,13,6,3,3,10,6,20,6,3
3,13,9,10,6,3,0,9,23,3
3,6,20,9,10,3,6,16,16,3
10,3,3,0,3,3,13,16,6,0
3,0,0,0,0,0,3,3,0,0
