0,3,10,3,3,26,13,6,13,3
0,3,6,0,3,13,6,3,13,3
3,16,16,6,3,6,3,0,3,0
3,19,19,26,19,16,13,3,0,0
3,13,9,6,13,9,3,0,0,0
0,6,10,3,9,13,6,3,0,0
0,3,3,3,13,19,19,26,3,0
6,13,3,0,3,9,19,16,3,0
13,26,3,0,3,13,16,6,0,0
3,3,0,0,0,3,3,0,0,0
