0,6,13,23,9,10,3,0,3,0
6,30,6,9,10,6,0,3,10,3
13,6,6,10,6,3,0,0,3,3
16,9,13,6,3,10,3,3,6,10
16,19,16,3,0,3,3,13,16,6
6,13,6,3,0,0,0,9,13,6
3,3,3,10,6,0,6,10,9,10
10,3,3,9,10,6,10,9,3,3
3,3,13,13,6,0,6,13,13,3
0,0,3,3,0,0,0,3,3,0
