3,0,3,13,19,16,6,6,23,3
10,6,0,9,16,19,16,19,16,3
6,13,9,23,6,3,6,13,6,3
3,19,16,16,6,0,3,6,6,10
3,13,6,6,10,6,13,16,13,9
0,3,0,0,3,0,3,3,6,13
0,3,0,0,3,0,0,0,6,26
3,13,3,3,13,3,0,6,26,16
3,13,3,3,13,3,3,13,16,6
0,3,0,0,3,0,0,3,3,0
