10,3,0,3,3,0,3,0,0,3
3,3,3,16,16,6,10,6,3,10
3,10,9,16,16,3,6,20,6,6
0,6,10,6,6,0,0,6,16,13
3,0,3,3,10,6,0,3,16,6
10,3,0,0,6,10,3,3,13,3
3,0,0,0,3,6,3,0,3,0
0,3,0,3,16,16,13,3,0,0
3,10,3,3,13,6,3,0,0,0
0,3,0,0,3,0,0,0,0,0
