0,3,13,6,13,16,16,6,0,0
0,3,16,3,3,6,26,13,3,3
0,3,26,3,0,3,3,3,3,10
3,3,16,3,6,23,3,0,0,3
10,6,13,6,36,19,3,3,3,3
6,0,3,3,19,16,9,13,16,13
20,3,0,3,13,9,20,6,3,3
6,3,0,3,3,0,6,0,3,0
13,13,6,10,3,3,10,6,10,3
3,3,0,3,0,0,3,0,3,0
