0,0,3,3,6,23,13,3,3,3
0,6,13,19,13,6,3,3,13,16
3,20,12,23,9,3,0,3,6,16
3,9,10,9,16,16,6,10,6,26
13,26,6,3,16,16,3,6,3,13
6,13,6,0,3,3,6,13,3,3
3,6,13,3,0,3,13,26,6,0
10,6,13,6,0,3,3,9,10,3
3,0,6,10,6,10,6,20,6,0
0,0,0,3,0,3,0,3,0,0
