13,16,3,3,13,13,3,3,0,3
6,13,3,0,3,3,3,10,6,10
0,3,0,0,0,0,3,3,3,6
0,0,3,3,0,3,10,6,36,13
0,3,13,13,3,3,6,6,16,6
0,0,3,6,6,13,16,16,26,3
0,0,3,16,16,6,3,6,3,3
3,3,3,16,16,3,3,20,6,13
13,13,3,3,3,0,0,3,3,13
3,3,0,0,0,0,0,0,0,3
