0,3,3,13,6,10,6,0,0,0
3,10,9,16,3,6,10,3,3,0
0,9,13,26,6,3,3,3,10,3
3,13,6,9,13,13,3,0,6,0
6,16,9,10,6,3,3,3,20,6
16,22,13,6,0,3,13,6,6,13
26,16,6,0,0,6,16,13,6,46
3,6,3,0,3,10,9,6,6,13
3,13,13,3,0,6,13,16,13,6
0,3,3,0,0,0,3,3,3,0
