3,3,23,6,16,23,6,3,10,3
13,6,13,6,13,9,10,3,3,3
16,3,3,0,3,0,3,0,3,10
13,6,0,3,3,0,0,0,3,3
6,10,9,13,13,3,3,3,20,3
0,9,23,6,6,3,10,3,6,0
6,13,19,9,13,3,6,6,10,3
10,9,26,16,19,9,23,13,6,3
3,0,3,6,26,13,6,3,3,10
0,0,0,0,3,3,0,0,0,3
