10,3,3,6,13,13,3,3,0,0
6,3,13,13,6,6,3,10,6,3
10,3,3,3,3,30,3,6,13,13
3,0,3,0,0,3,3,3,3,3
0,3,10,6,0,3,13,13,6,0
3,0,6,10,3,0,3,9,10,6
10,3,0,6,0,0,3,10,9,13
6,0,3,13,3,3,0,3,3,13
20,3,3,13,6,10,3,0,0,3
3,0,0,3,0,3,0,0,0,0
