0,0,3,0,6,10,3,3,0,0
3,6,10,6,10,9,6,10,6,0
13,13,6,0,6,13,13,9,23,3
3,6,0,0,0,3,3,3,23,3
3,10,6,3,0,0,0,3,3,0
3,6,16,16,3,0,3,13,3,0
10,6,26,16,3,0,3,16,3,0
3,0,6,3,0,0,6,13,3,0
0,3,10,3,0,3,20,6,0,0
0,0,3,0,0,0,3,0,0,0
