13,6,10,3,0,6,13,13,3,0
16,3,6,0,3,10,6,6,0,0
13,6,23,6,3,3,6,10,3,0
6,3,16,16,13,6,20,6,3,0
10,3,3,6,3,0,3,3,20,3
3,0,3,13,3,0,0,0,3,3
0,3,3,16,3,3,0,0,3,13
3,10,6,13,9,10,6,0,6,13
0,3,0,6,10,9,10,6,20,6
0,0,0,0,3,0,3,0,3,0
