0,3,13,13,3,0,3,3,10,3
0,3,3,6,0,6,10,3,3,0
3,20,9,10,6,10,6,0,3,0
0,6,10,6,0,3,0,3,10,3
0,0,3,0,0,0,3,0,3,3
3,0,0,0,0,6,10,3,6,13
20,6,0,0,3,13,6,6,16,16
9,13,3,0,3,16,9,13,16,9
13,16,3,0,3,16,13,6,6,10
3,3,0,0,0,3,3,0,0,3
