3,3,10,6,0,0,0,0,0,3
13,3,6,10,3,0,3,0,3,10
13,6,0,3,3,3,10,3,0,6
6,10,3,6,10,3,6,0,6,10
3,6,3,10,6,3,13,9,23,6
13,16,3,6,0,3,16,16,16,3
6,16,6,13,3,0,3,3,6,3
6,16,9,13,6,0,0,3,23,13
23,29,13,9,10,3,0,0,3,3
3,3,3,0,3,0,0,0,0,0
