0,0,0,0,3,13,13,6,13,3
0,3,0,0,0,3,6,6,16,3
6,10,6,3,0,3,16,16,16,3
10,9,16,16,3,3,16,9,3,0
3,3,19,19,3,3,16,26,3,0
0,6,16,19,3,0,6,13,3,0
3,10,9,16,3,0,3,3,3,0
3,6,6,23,6,6,10,6,20,3
13,16,13,9,13,13,6,0,3,0
3,3,3,0,3,3,0,0,0,0
