0,3,0,3,16,16,13,9,10,3
3,23,3,3,13,6,9,10,6,3
3,13,6,0,6,3,10,9,3,13
0,6,10,9,10,3,6,10,6,16
0,0,6,10,6,3,0,3,3,13
3,0,0,3,3,13,3,0,3,6
10,3,0,0,3,16,6,3,13,13
3,0,3,0,3,16,13,3,6,6
0,3,10,3,0,3,3,3,13,13
0,0,3,0,0,0,0,0,3,3
