0,3,0,6,20,6,23,16,3,0
3,13,6,10,6,0,6,16,3,0
3,13,3,3,0,0,3,13,3,0
3,3,0,0,0,0,0,3,0,0
10,3,0,0,0,3,0,0,3,3
3,3,0,0,6,13,6,6,13,13
3,13,3,6,16,19,16,23,6,6
6,16,6,13,19,6,6,3,3,10
13,16,3,6,13,6,10,3,0,3
3,3,0,0,3,0,3,0,0,0
