10,3,0,3,13,16,3,0,0,0
6,0,0,0,6,13,3,3,0,3
10,6,0,0,3,3,3,10,6,10
9,10,3,6,10,3,0,3,0,3
10,9,6,10,6,0,0,3,0,3
9,16,13,9,3,0,3,10,6,10
13,16,12,16,23,3,0,3,3,6
6,9,16,16,9,3,0,6,16,13
13,16,16,9,13,13,6,13,16,6
3,3,3,0,3,3,0,3,3,0
