13,6,10,3,3,10,6,0,0,3
13,3,6,0,0,9,13,3,6,10
3,3,10,6,6,23,16,6,10,9
3,3,6,23,23,9,3,0,9,20
16,13,6,6,6,10,3,3,10,9
13,12,13,13,3,6,0,0,6,20
6,10,6,3,3,13,6,3,0,3
0,3,0,3,6,16,16,23,6,0
0,0,3,13,13,6,3,6,20,3
0,0,0,3,3,0,0,0,3,0
