0,0,0,0,3,0,0,0,0,0
0,3,3,3,23,3,3,3,3,3
6,23,13,9,16,6,13,26,19,16
13,6,9,13,19,3,3,6,16,26
13,6,10,12,13,3,0,0,3,3
3,0,6,10,6,0,3,0,0,0
0,0,0,6,0,6,10,6,0,0
0,3,3,10,9,20,9,10,6,3
3,10,3,6,10,6,0,6,23,13
0,3,0,0,3,0,0,0,3,3
