13,13,6,0,3,13,26,16,6,0
6,6,23,6,0,3,6,16,26,3
10,6,19,13,3,3,3,6,16,3
6,3,13,6,3,13,16,6,13,3
10,6,3,0,3,6,13,3,6,3
6,20,3,3,10,3,3,6,13,13
0,6,0,0,6,0,6,10,9,3
3,13,3,3,10,6,20,9,10,6
3,13,3,0,3,0,3,0,6,10
0,3,0,0,0,0,0,0,0,3
