10,3,6,13,6,0,6,13,13,3
3,3,13,19,16,6,10,6,6,0
0,0,6,6,16,3,6,3,13,3
0,3,10,6,13,6,13,6,16,3
3,0,6,0,3,3,13,6,13,3
10,6,30,3,3,3,6,0,3,0
6,3,3,6,16,26,23,6,3,0
16,13,9,16,19,9,6,16,13,3
23,9,13,19,19,13,6,13,6,0
3,0,3,3,3,3,0,3,0,0
