16,13,9,20,6,0,0,0,0,0
16,9,10,9,23,3,3,3,0,0
33,3,6,6,23,6,13,16,6,3
3,3,13,23,6,0,6,16,16,16
0,0,3,3,0,0,0,3,6,16
0,3,0,0,0,0,3,0,3,16
3,13,3,0,0,6,20,3,3,13
3,23,6,0,3,10,6,0,0,3
0,6,10,3,0,3,0,0,0,0
0,0,3,0,0,0,0,0,0,0
