3,3,23,3,3,10,6,0,0,0
13,6,13,3,3,9,10,6,3,0
13,6,3,3,16,23,9,13,23,3
9,10,3,3,16,9,0,3,3,0
13,6,0,6,26,13,3,0,0,3
13,3,6,10,6,3,0,0,6,10
3,3,13,6,3,0,0,3,10,6
0,3,13,6,10,3,0,0,6,0
0,0,3,0,3,0,0,3,10,3
0,0,0,0,0,0,0,0,3,0
