0,3,0,3,0,0,0,3,3,0
3,13,6,10,6,0,6,13,13,3
6,13,6,6,10,6,10,9,3,3
10,9,10,3,6,3,6,10,6,10
3,0,6,6,13,16,3,6,0,3
0,6,36,13,12,13,6,10,6,0
6,23,16,9,10,9,0,6,13,3
10,6,3,0,6,13,6,3,16,6
3,0,0,0,3,16,13,6,16,13
0,0,0,0,0,3,3,0,3,3
