13,9,23,6,10,3,0,0,0,3
16,16,16,3,3,3,0,0,3,13
3,6,6,3,3,20,3,3,3,16
3,13,16,13,3,6,3,13,6,13
0,3,6,6,6,10,9,13,6,6
0,6,16,26,13,9,13,12,13,13
3,13,16,9,6,3,19,13,6,6
0,3,6,16,13,6,16,6,3,10
0,0,3,13,6,3,13,3,0,3
0,0,0,3,0,0,3,0,0,0
