6,23,16,6,3,6,10,6,0,0
20,12,16,19,16,13,9,10,6,0
6,10,9,13,6,6,3,6,10,3
0,3,0,6,6,26,13,6,3,3
0,3,6,13,16,16,9,10,6,10
6,16,13,9,6,6,0,3,3,3
13,16,9,13,19,13,6,3,20,6
3,6,0,6,13,12,13,6,6,10
3,10,3,0,6,13,29,23,3,3
0,3,0,0,0,3,3,3,0,0
