0,6,23,16,3,0,0,0,0,0
3,10,12,13,3,3,0,3,0,3
0,6,20,6,6,30,6,10,6,10
3,3,3,6,10,9,0,3,3,3
13,13,6,10,12,13,6,3,13,3
3,6,3,6,23,22,16,9,13,3
3,13,13,3,6,19,19,23,9,0
0,3,3,0,3,26,9,6,10,3
0,0,0,0,3,16,23,3,3,0
0,0,0,0,0,3,3,0,0,0
