13,16,13,3,0,3,0,3,3,3
3,6,3,3,3,10,9,13,26,13
3,10,6,10,3,6,10,6,6,3
0,3,0,3,3,0,3,3,23,6
0,0,0,3,13,3,0,6,19,13
0,0,3,3,13,6,3,13,16,6
3,3,10,3,6,20,3,3,3,0
13,3,6,3,0,3,0,3,0,0
13,6,23,13,3,0,3,10,3,0
3,0,3,3,0,0,0,3,0,0
