0,3,3,10,3,6,23,9,23,3
3,10,3,6,3,13,22,16,19,3
0,3,3,10,6,6,13,9,13,3
0,0,0,6,20,3,3,0,3,3
0,0,0,3,3,0,0,0,3,10
0,0,6,10,3,0,0,0,3,6
0,6,10,6,3,0,3,6,13,13
6,23,6,6,10,6,13,16,9,6
13,16,6,10,6,0,6,36,16,13
3,3,0,3,0,0,0,3,3,3
