0,3,10,3,0,0,6,16,16,3
0,0,3,3,3,6,26,19,26,3
0,0,6,13,16,16,26,6,3,0
0,3,10,6,6,6,6,0,0,0
0,0,6,3,16,16,13,3,0,3
0,6,10,6,16,6,3,0,6,13
3,10,6,6,13,6,0,6,16,16
3,6,3,10,9,10,6,13,16,6
13,13,3,3,0,3,0,3,3,0
3,3,0,0,0,0,0,0,0,0
