0,6,20,3,6,10,6,3,10,3
3,20,6,3,10,12,10,6,3,0
0,3,0,3,6,10,9,10,3,0
0,0,3,10,3,6,3,6,3,3
0,0,0,3,6,16,16,16,26,16
3,0,3,6,13,16,9,3,9,16
10,6,23,13,6,6,20,6,16,16
3,3,3,3,0,0,3,6,16,6
3,10,3,0,0,0,3,13,16,3
0,3,0,0,0,0,0,3,3,0
