0,0,3,13,23,6,0,0,3,3
3,0,3,3,6,10,3,3,13,13
10,6,10,3,0,3,0,0,6,6
3,3,3,0,0,0,0,3,16,13
6,10,3,3,3,3,0,6,13,6
13,6,6,13,19,13,9,10,6,3
13,6,10,9,13,9,13,9,3,13
6,0,3,0,3,3,16,26,9,13
30,3,0,0,0,0,6,16,13,6
3,0,0,0,0,0,0,3,3,0
