0,0,3,0,3,10,3,3,0,0
0,6,13,6,0,3,6,10,3,0
3,16,22,13,3,6,10,9,3,0
3,16,19,6,3,10,9,13,16,6
0,6,23,3,0,3,0,6,16,13
0,0,3,0,3,3,0,0,3,3
3,0,3,3,16,16,3,0,0,3
13,6,10,6,16,19,3,3,6,20
13,3,3,0,6,13,6,13,13,6
3,0,0,0,0,3,0,3,3,0
