3,0,0,0,3,10,3,6,10,3
13,6,0,3,0,3,3,13,9,0
29,13,9,13,6,3,3,16,23,3
13,9,13,29,16,13,3,6,3,0
3,3,6,3,6,3,3,13,3,0
3,16,13,6,20,6,3,13,3,0
3,13,6,0,9,10,3,3,3,0
0,3,3,3,13,9,0,3,10,6
0,3,10,6,16,13,3,0,6,10
0,0,3,0,3,3,0,0,0,3
