0,3,0,3,10,3,6,13,16,3
3,10,6,0,6,6,20,12,13,3
0,9,23,6,13,13,9,10,6,0
6,16,16,6,3,3,3,3,0,0
16,19,9,13,3,6,10,3,0,0
16,16,9,16,9,10,6,0,3,0
3,6,13,19,16,9,0,3,10,3
0,0,3,6,26,13,3,0,3,3
0,0,0,0,3,3,0,0,3,10
0,0,0,0,0,0,0,0,0,3
