10,3,3,10,6,10,6,0,0,0
3,0,0,3,0,6,10,3,3,3
3,0,0,3,3,0,3,6,13,13
10,3,6,13,23,3,3,10,6,3
3,3,10,6,3,0,0,3,0,0
0,0,3,0,0,0,0,0,0,3
3,3,0,0,0,0,0,0,3,13
13,13,3,0,0,0,0,0,6,16
3,3,0,0,0,0,0,3,13,16
0,0,0,0,0,0,0,0,3,3
