6,10,6,10,6,10,3,0,3,0
13,6,0,3,3,3,3,6,10,6
13,6,0,3,10,9,13,13,12,10
6,10,3,0,6,10,9,6,13,6
0,3,0,0,0,9,10,6,13,3
0,0,0,0,3,23,6,0,3,3
0,3,0,3,6,13,3,0,3,13
3,13,6,13,26,6,0,0,3,23
3,13,3,6,13,3,0,0,0,3
0,3,0,0,3,0,0,0,0,0
