26,26,3,0,3,20,9,10,3,0
16,29,3,3,0,6,13,6,3,0
6,13,6,10,3,3,16,6,10,3
0,6,3,3,3,3,13,6,6,0
3,13,16,6,10,3,9,16,13,3
3,9,16,6,3,3,13,19,6,0
16,16,22,16,6,3,6,23,3,3
13,9,19,19,26,16,3,3,3,13
3,3,13,6,6,13,3,0,3,13
0,0,3,0,0,3,0,0,0,3
