13,19,16,6,13,3,3,10,3,3
6,19,19,6,16,3,3,3,6,10
3,16,16,6,16,6,10,9,10,6
0,3,3,3,13,3,6,10,6,3
3,3,0,0,3,3,3,6,6,10
13,16,6,3,3,13,16,16,13,6
6,16,19,13,3,6,3,3,6,0
0,6,13,6,3,10,3,6,13,3
0,0,3,0,0,3,3,13,16,3
0,0,0,0,0,0,0,3,3,0
