13,9,10,6,3,10,6,20,3,0
26,13,9,10,6,3,0,3,3,3
6,3,0,6,20,3,0,6,16,16
10,3,0,3,3,0,3,13,19,16
6,0,3,10,3,0,3,3,6,6
20,6,0,3,0,6,10,6,16,23
9,10,6,3,3,10,9,3,16,6
20,9,13,16,6,6,10,9,16,3
3,0,6,16,13,3,6,13,16,3
0,0,0,3,3,0,0,3,3,0
