0,3,3,16,16,16,6,3,0,0
6,10,6,16,9,16,19,26,3,3
10,9,3,16,3,9,16,16,6,10
9,13,6,13,9,10,9,3,0,3
13,16,3,9,10,12,13,3,3,0
3,3,3,10,9,13,16,6,10,3
0,3,3,3,0,3,3,3,3,0
6,13,13,3,0,0,3,13,3,0
10,6,3,0,0,0,3,23,3,0
3,0,0,0,0,0,0,3,0,0
