0,3,13,13,3,0,0,3,3,3
3,3,3,3,3,3,3,13,16,13
13,13,3,6,13,13,3,3,3,6
3,6,6,10,6,3,0,0,6,13
6,23,16,9,0,0,3,3,13,16
23,9,16,13,3,6,20,6,3,3
13,3,3,3,3,13,12,13,3,0
3,3,0,3,3,16,16,19,3,3
3,10,6,10,3,3,6,13,6,10
0,3,0,3,0,0,0,3,0,3
