3,13,13,3,0,3,0,0,0,3
3,3,3,0,6,23,3,3,3,13
10,3,0,3,13,19,6,10,9,13
3,0,0,0,6,13,3,9,20,6
0,0,0,0,3,3,6,30,6,0
3,0,0,3,10,9,13,6,3,3
10,3,3,3,9,16,26,9,13,16
3,3,13,16,19,16,12,13,12,13
0,0,3,6,13,9,13,19,13,6
0,0,0,0,3,0,3,3,3,0
