0,3,16,16,13,3,0,0,0,0
0,6,13,6,6,0,3,0,3,0
3,13,6,3,10,6,13,9,13,3
3,23,6,3,3,3,19,19,19,3
3,6,26,13,6,3,16,19,16,6
13,6,16,9,10,3,3,3,9,13
13,6,26,3,3,3,0,6,13,19
3,3,23,6,3,10,6,20,9,13
0,0,6,10,3,3,0,3,0,3
0,0,0,3,0,0,0,0,0,0
