3,6,10,6,3,3,20,6,0,3
13,13,12,16,13,3,6,13,6,20
6,6,13,16,9,0,3,16,3,3
13,3,6,6,10,6,6,13,3,3
16,6,13,3,9,13,13,6,3,10
13,6,26,6,13,6,3,0,0,6
3,6,16,9,13,3,3,0,3,10
3,26,22,13,9,6,10,3,3,3
3,16,26,9,13,13,6,3,10,3
0,3,3,0,3,3,0,0,3,0
