0,3,0,3,10,3,3,3,10,3
3,10,6,0,3,3,10,6,3,0
0,6,13,3,0,0,6,10,3,0
0,6,13,3,0,0,0,6,3,3
6,13,6,3,0,3,6,16,26,16
13,16,6,13,6,16,19,16,9,13
6,6,3,16,6,19,16,6,0,6
13,13,9,13,6,16,9,3,3,13
3,6,10,6,3,16,16,13,6,13
0,0,3,0,0,3,3,3,0,3
