0,0,3,13,13,3,0,0,0,3
0,3,0,3,6,0,0,0,3,13
3,13,3,3,10,6,3,0,6,13
6,13,3,3,6,13,16,9,10,6
10,6,3,10,3,9,16,13,9,0
6,0,3,6,3,13,9,9,23,3
13,6,33,13,6,19,26,16,16,6
23,6,3,3,6,16,6,3,6,13
6,10,3,3,13,26,3,0,3,13
0,3,0,0,3,3,0,0,0,3
