0,0,0,0,3,13,6,10,3,3
0,0,3,0,3,13,3,3,3,20
0,3,20,3,0,3,0,0,3,3
0,0,3,3,3,0,0,6,13,3
3,3,6,13,16,3,3,13,29,6
23,16,13,12,13,3,0,9,19,13
3,3,6,10,9,0,3,13,16,6
3,0,3,6,10,3,0,6,3,0
10,6,10,3,3,0,3,20,3,0
3,0,3,0,0,0,0,3,0,0
