3,16,19,13,6,10,3,0,0,3
3,19,26,9,0,3,0,0,3,10
3,16,9,10,3,0,3,3,0,3
3,13,3,3,0,3,16,33,3,0
3,3,3,0,3,3,26,6,0,0
10,6,20,9,10,9,23,6,0,0
3,3,6,20,9,20,9,10,6,0
6,13,3,3,3,6,0,6,10,3
13,16,3,3,13,13,3,0,3,0
3,3,0,0,3,3,0,0,0,0
