0,3,0,3,23,6,3,13,13,3
6,20,3,3,16,23,3,3,3,0
20,9,0,0,3,6,0,3,3,0
6,10,3,0,3,10,6,16,13,6
3,6,0,0,3,3,3,23,9,10
13,26,3,6,13,3,3,3,0,3
6,16,6,13,16,6,10,6,3,3
3,26,3,3,3,0,9,16,19,26
3,13,3,0,0,3,13,19,19,16
0,3,0,0,0,0,3,3,3,3
