0,0,0,0,0,6,10,3,0,0
3,0,3,0,3,23,6,0,0,0
10,9,10,6,3,13,3,0,3,3
6,10,9,10,3,6,0,3,16,16
0,6,0,3,3,10,3,6,19,16
3,10,3,0,3,3,3,16,16,9
0,3,3,3,10,6,3,13,9,20
0,3,13,3,6,10,3,3,0,6
0,3,13,3,0,3,0,0,3,10
0,0,3,0,0,0,0,0,0,3
