0,3,0,3,13,6,0,0,0,0
6,20,6,3,16,13,3,0,0,0
10,9,13,6,6,3,0,0,0,0
6,6,19,19,13,6,0,0,3,0
16,16,19,19,12,13,3,3,13,3
16,6,9,16,16,19,3,6,26,3
13,9,10,6,6,13,6,13,19,3
6,20,9,3,0,3,0,6,13,3
0,6,13,13,3,0,0,0,3,0
0,0,3,3,0,0,0,0,0,0
