13,16,13,6,13,19,19,13,3,0
3,6,3,0,9,16,16,6,0,3
3,13,3,3,13,6,6,0,6,13
3,23,6,3,16,6,13,6,16,16
0,6,13,6,13,6,13,6,23,9
0,3,16,3,3,0,3,3,6,13
0,3,13,6,0,3,6,13,9,13
3,0,9,10,6,13,19,22,13,6
10,6,10,6,0,6,16,16,6,0
3,0,3,0,0,0,3,3,0,0
