3,10,6,10,3,0,3,0,3,0
3,3,0,3,0,3,10,6,10,6
10,3,3,0,0,3,3,0,6,10
6,6,10,3,3,13,6,0,0,6
13,13,6,0,3,16,13,6,3,20
3,3,3,0,3,6,9,13,6,3
3,3,10,6,13,19,19,19,13,3
10,3,6,0,9,29,16,6,6,0
3,3,10,6,13,26,6,3,10,3
0,0,3,0,3,3,0,0,3,0
