10,3,0,3,3,10,6,10,6,0
3,0,3,10,6,3,0,6,10,3
3,0,0,9,13,3,3,3,3,3
10,3,3,16,19,9,13,13,6,13
6,3,6,19,19,23,6,6,3,13
13,19,19,16,6,3,3,13,3,3
9,16,16,6,0,0,6,13,3,0
33,9,3,3,0,6,10,6,0,3
16,13,6,10,6,10,6,0,3,10
3,3,0,3,0,3,0,0,0,3
