3,16,16,6,3,3,10,9,20,3
3,19,22,19,13,6,9,10,6,3
3,16,22,19,9,13,13,6,3,10
3,9,19,26,3,3,6,0,3,3
16,19,16,9,0,3,10,9,13,3
16,19,12,10,3,3,6,23,19,6
9,19,16,6,3,20,3,6,19,13
13,19,16,3,3,3,0,3,13,6
3,3,3,3,10,3,0,0,3,0
0,0,0,0,3,0,0,0,0,0
