10,6,13,13,3,3,3,13,16,3
3,0,3,3,3,13,3,9,13,3
3,3,0,0,3,13,6,10,9,0
13,13,3,0,3,3,0,9,13,3
3,3,0,3,13,3,6,13,19,3
0,0,0,3,13,9,20,9,13,3
3,3,3,3,6,23,9,3,3,0
13,16,16,16,9,16,19,16,3,0
3,3,6,16,23,9,16,16,3,0
0,0,0,3,3,0,3,3,0,0
