3,13,13,6,3,3,0,3,0,0
0,3,6,13,16,13,9,10,3,0
3,0,0,3,6,9,10,6,0,3
10,3,0,3,26,13,6,3,3,10
3,0,3,3,13,6,3,10,6,6
0,3,13,3,3,0,0,9,13,16
0,6,13,6,0,0,3,10,9,13
6,20,9,13,3,0,3,3,0,6
10,6,3,13,3,3,20,3,3,20
3,0,0,3,0,0,3,0,0,3
