0,3,0,0,6,10,3,6,10,3
6,10,3,3,10,6,3,20,6,0
10,9,3,0,3,0,0,6,0,0
9,16,16,3,0,3,3,10,6,3
13,19,16,6,3,20,6,6,16,16
6,6,6,13,6,6,10,9,19,26
13,16,9,19,13,3,6,13,16,6
9,29,16,19,6,0,3,3,6,3
23,36,9,23,3,3,10,6,13,13
3,3,0,3,0,0,3,0,3,3
