0,3,13,13,9,10,3,3,23,3
0,3,6,9,10,9,0,3,16,3
3,13,16,13,9,20,3,3,13,3
0,6,3,3,3,3,3,0,6,3
6,10,3,3,10,6,10,9,16,16
13,9,0,0,6,0,6,13,22,16
26,23,3,3,10,6,0,6,23,6
3,3,0,0,6,10,6,3,3,3
0,0,0,0,0,6,13,13,6,10
0,0,0,0,0,0,3,3,0,3
