10,6,33,3,0,3,0,3,10,3
3,3,16,3,3,20,6,0,3,0
0,3,13,3,0,6,10,6,3,3
0,0,3,0,3,0,6,13,19,23
0,0,3,6,10,3,0,9,13,9
0,3,23,13,6,0,3,10,9,10
0,0,3,3,0,3,3,6,3,3
3,0,0,3,6,16,16,16,13,3
20,3,3,23,26,16,6,3,3,0
3,0,0,3,3,3,0,0,0,0
