0,3,13,19,16,13,3,3,0,0
0,0,6,16,6,3,3,13,3,3
3,0,3,16,3,3,6,13,9,13
13,6,6,33,6,16,13,9,13,16
19,19,16,6,3,16,6,3,3,3
16,19,19,6,3,13,6,13,3,3
6,9,19,13,6,6,3,13,6,20
13,16,16,9,16,16,3,3,3,6
3,3,3,3,16,26,3,3,13,13
0,0,0,0,3,3,0,0,3,3
