0,0,6,13,16,13,3,0,0,0
0,6,10,6,3,6,3,3,3,0
6,10,6,3,6,13,19,16,13,6
10,9,3,13,23,9,16,6,9,10
6,20,6,3,3,6,33,6,10,6
0,6,13,3,3,10,9,3,6,0
0,6,13,3,0,6,13,16,16,3
3,20,9,3,0,0,3,6,13,3
0,6,13,23,3,0,0,0,3,0
0,0,3,3,0,0,0,0,0,0
