13,6,3,10,3,0,3,10,3,0
16,13,6,3,3,3,0,3,0,3
6,9,13,6,13,13,3,3,6,10
13,19,16,3,3,3,6,13,13,6
9,16,9,0,0,6,10,6,3,0
13,19,13,6,3,13,6,0,0,0
3,3,6,10,6,13,3,0,0,0
0,0,0,3,3,6,0,0,0,0
0,0,0,3,23,13,3,0,0,0
0,0,0,0,3,3,0,0,0,0
