0,0,3,16,13,6,0,0,3,3
3,0,3,16,12,10,3,3,13,16
10,3,3,19,13,6,0,3,6,13
6,3,3,13,6,0,3,10,3,3
16,26,3,6,0,0,3,3,0,0
16,16,6,20,6,6,10,6,3,0
3,6,0,6,13,16,12,13,23,3
6,20,3,3,6,16,13,6,6,3
10,6,3,10,3,3,3,3,13,13
3,0,0,3,0,0,0,0,3,3
