16,16,13,3,0,3,0,0,0,0
13,6,6,0,6,10,3,3,0,3
6,3,10,6,10,9,3,10,6,23
10,3,6,3,6,13,6,6,6,13
3,6,13,16,6,16,19,16,16,9
3,20,12,13,3,6,13,9,16,13
3,6,10,9,0,3,3,0,3,3
20,3,6,10,6,10,3,3,0,3
3,0,0,3,0,3,3,10,6,20
0,0,0,0,0,0,0,3,0,3
