3,0,0,3,13,6,16,16,3,0
23,3,3,6,16,9,26,19,3,3
13,9,13,19,22,13,9,13,6,10
6,10,9,19,36,6,3,3,3,6
0,3,6,16,9,6,10,6,13,16
0,3,13,22,16,16,6,0,6,13
0,0,9,23,9,16,3,0,3,6
0,3,10,9,3,13,3,6,13,16
0,0,6,10,3,3,3,10,9,23
0,0,0,3,0,0,0,3,0,3
