3,13,6,3,0,3,0,3,13,3
3,16,19,13,6,13,3,3,16,3
3,6,16,9,6,13,3,3,13,3
10,9,19,16,13,6,3,0,3,3
6,13,16,9,6,3,13,3,3,13
3,6,6,13,13,9,23,3,6,13
13,26,6,3,9,10,9,3,10,9
6,26,13,9,10,9,20,6,6,13
0,3,6,10,6,0,6,10,6,13
0,0,0,3,0,0,0,3,0,3
