10,6,0,3,13,6,10,9,10,3
6,10,3,3,16,3,6,10,6,3
0,6,0,3,13,3,0,3,3,13
6,10,3,0,6,0,0,3,3,13
20,6,3,3,13,3,3,10,3,3
6,6,10,9,13,3,0,3,3,3
23,13,9,13,6,0,3,3,13,13
3,3,3,13,3,3,13,3,6,3
0,0,0,3,0,3,13,6,10,3
0,0,0,0,0,0,3,0,3,0
