3,10,3,0,3,13,6,0,0,0
0,3,0,3,3,16,16,3,0,0
0,3,3,10,3,6,23,3,0,0
3,23,3,6,0,0,3,0,0,3
3,13,6,10,3,0,3,0,3,13
0,3,0,3,3,3,20,6,6,26
0,0,0,6,10,3,9,23,16,19
3,0,3,10,9,3,10,9,6,16
10,3,0,6,20,3,6,10,6,13
3,0,0,0,3,0,0,3,0,3
