0,0,3,13,3,3,10,6,10,3
0,0,3,23,3,0,3,0,3,0
3,0,0,3,0,3,3,0,0,0
13,3,0,0,3,13,36,3,0,3
16,3,3,3,3,6,13,3,6,10
16,6,16,29,13,6,6,3,13,6
13,9,26,16,9,13,13,6,13,3
6,20,9,3,0,3,3,3,3,0
0,6,10,3,0,0,3,10,3,0
0,0,3,0,0,0,0,3,0,0
