3,6,23,26,26,16,3,0,3,0
16,13,9,6,9,16,3,6,10,3
23,12,13,19,16,16,9,13,9,0
6,10,9,16,6,6,16,32,13,3
3,3,3,13,6,6,16,16,6,0
10,6,0,6,16,13,6,6,3,3
9,13,6,3,16,6,3,13,16,16
13,19,23,9,13,3,3,3,6,23
3,3,6,10,6,3,10,3,0,3
0,0,0,3,0,0,3,0,0,0
