3,13,13,6,20,3,3,3,10,3
0,3,6,0,3,6,10,3,6,0
0,3,23,3,6,10,6,3,10,3
0,6,13,9,10,9,3,3,3,3
3,20,9,13,9,13,16,13,6,13
0,3,3,23,3,6,3,3,3,16
0,0,0,3,6,13,3,3,3,13
3,0,3,6,13,19,6,10,3,3
10,6,13,13,9,13,3,3,0,0
3,0,3,3,0,3,0,0,0,0
