0,0,0,0,0,3,3,0,0,3
3,0,0,0,6,23,16,3,6,20
30,3,0,3,20,9,13,6,10,9
6,0,0,0,3,0,3,3,6,10
13,3,0,0,0,0,3,23,3,3
13,6,0,0,0,0,3,23,6,0
9,10,3,0,3,3,0,6,10,3
10,6,3,3,13,13,3,3,3,0
3,3,10,3,3,3,3,20,3,0
0,0,3,0,0,0,0,3,0,0
