10,3,0,6,20,6,10,3,3,0
3,0,6,10,6,0,3,3,10,6
3,3,20,9,0,0,3,0,6,13
20,3,6,10,3,3,10,3,3,13
3,3,0,3,3,0,3,3,0,3
6,10,6,3,10,6,3,10,3,0
10,12,13,6,6,10,3,3,0,0
6,26,22,26,3,3,0,3,0,0
3,16,19,16,3,0,3,10,3,0
0,3,3,3,0,0,0,3,0,0
